11111111111111111111111111111111111111111
10000000000000000000011111111111111111111
10011100001100001110011111111111111111111
10000111010010111000011111111111111111111
10000001110011100000011111111111111111111
10110000011110000011011111111111111111111
1P011111001100111110011111111111111111111
10110000011110000011011111111111111111111
10000001110011100000011111111111111111111
10000111010010111000011111111111111111111
10011100001100001110011111111111111111111
10000000000000000000011111111111111111111
11111111111111111111111111111111111111111
11111111111111111111111111111111111111111
11111111111111111111111111111111111111111
11111111111111111111111111111111111111111
11111111111111111111111111111111111111111
11111111111111111111111111111111111111111
11111111111111111111111111111111111111111
11111111111111111111111111111111111111111
11111111111111111111111111111111111111111

