SO../textures/south_texture.png
WE  			../textures/west_texture.png
EA../textures/east_texture.png
NO                 ../textures/north_texture.png

F 40	, 24,			30
C 53        , 94,70

1111111111111111111111111111111111111111111111111111111111
100000P011110000000011111110000000001111110000000011111111
1011111010010111111010000010111111101000010111111010000001
1010001010010100001010111110100000101011110100001010111101
1010111011110101111010100010101110101000010101111010000101
1010100010000101000010101110101000101111010101000010110101
1010111110111101011110100000101111100000010101111110100101
1010000010100001000010111111100000111111010100000010100101
1011111010111111111010000000111110100000010111111011100101
1000001010000000001010111110100000101111110100001010000101
1011101011111111101010100010111111101000010111111010111101
1010101000000000101010111110100000001011110100000010100001
1010111111111110101010000010111111111010000111111010111101
1010000000000010101001111110100000000010111100001010000001
1011111111111010101110000010111111111010000011111011111101
1000000011110000000011111110000000001111110000000011111111
1011111010010111111010000010111111101000010111111010000001
1010001010010100001010111110100000101011110100001010111101
1010111011110101111010100010101110101000010101111010000101
1010100010000101000010101110101000101111010101000010110101
1010111110111101011110100000101111100000010101111110100101
1010000010100001000010111111100000111111010100000010100101
1011111010111111111010000000111110100000010111111011100101
1000001010000000001010111110100000101111110100001010000101
1011101011111111101010100010111111101000010111111010111101
1010101000000000101010111110100000001011110100000010100001
1010111111111110101010000010111111111010000111111010111101
1010000000000010101001111110100000000010111100001010000001
1011111111111010101110000010111111111010000011111011111101
1000000000000010000000000000000000000000000000000000000001
1111111111111111111111111111111111111111111111111111111111
