111111111111111111111111
1000000000000000000C0001
101111111100000111111101
10100C000100000100000101
101011110111111101110101
101010000100000100010101
101011111100C00111110101
101000000000000000000101
101111111111111111111101
1P0000000E0000000C000001
111111111111111111111111
