SO../textures/south_texture.png
WE  			../textures/west_texture.png
EA../textures/east_texture.png
NO                 ../textures/north_texture.png

F 40,24,30
C 53,94,70

1111111111
1000000001
1001000001
110001P001
1000011001
1111111111
