NO ../textures/north_texture.png
SO ../textures/south_texture.png
WE ../textures/west_texture.png
EA ../textures/east_texture.png

F 255,0,255
C 225,30,0

11111111111111
1110000000000111111111
11000000100111111111
1000000000000111
11100000000001
10000000000001
1P00000110000111111111111
11111111111111
