NO ../textures/north_texture.png
SO ../textures/south_texture.png
WE ../textures/west_texture.png
EA ../textures/east_texture.png

F 255,0,255
C 225,30,0

11111111111111
11100000000001
11000000100111
10000000000001
11100000000001
10000000000001
1P000001100001
11111111111111
