1111111111
10000001E1
1001000C01
110001P001
1000011001
1111111111
