11111111111111
11100C000000E1
1100e000100111
10C00000000001
11100000000C01
10000000000001
1P0C0001100001
11111111111111
