111111111111111111
1000C00001000000E1
101111110101111101
10100C010101000101
101011110101110101
1010000000C0000101
101111111111111101
1P00000000C0000001
111111111111111111
