111111111111111111
100000000100000001
101111110101111101
101000010101000101
101011110101110101
101000000000000101
101111111111111101
1P0000000000000001
111111111111111111
