1111111111111111111111
1000000000000000000001
1001110000110000111001
10C00111010010111000C1
1000000111001110000001
1011000001111000001101
1P011111001100111110E1
1011000001111000001101
1000000111001110000001
10C00111010010111000C1
1001110000110000111001
100000000C000C00000001
1111111111111111111111
