1111111111111111111111
1000000000000000000001
1001110000110000111001
1000011101001011100001
1000000111001110000001
1011000001111000001101
1P01111100110011111001
1011000001111000001101
1000000111001110000001
1000011101001011100001
1001110000110000111001
1000000000000000000001
1111111111111111111111
