1111111111
1000C001E1
10010000g1
110001P001
10C0011C01
1111111111
