1111111111
1000000101
10010000g1
110001P001
1000011001
1111111111
